**************************************************
*X*XXXXX*X*XXX*X*XXXXX*XXX*X*X*XXX*XXXXX*X*X*XXXXX
*X***X***X*X***X***X***X***X*X***X***X***X*X*****X
*X*XXXXX*XXXXX*XXX*X*XXXXXXXXX*X*XXXXXXXXXXXXXXX*X
*X*****X*****X***X*X***X*******X*X***************X
XXXXXXXXXX*XXX*XXX*XXXXXXXXXXX*XXX*XXX*XXXXXXXXX*X
*************X***X*********X*****X***X*X*********X
*X*X*X*X*XXX*XXX*XXX*X*X*X*XXXXX*XXX*X*X*X*X*X*XXX
*X*X*X*X*X*****X*X***X*X*X***X***X***X*X*X*X*X***X
XX*X*XXXXX*XXX*X*XXX*XXX*XXX*X*XXX*XXXXXXXXX*X*X*X
***X*****X*X***X***X***X*X***X*X*******X*****X*X*X
*XXX*XXXXXXX*XXXXXXX*X*X*XXXXX*X*X*X*X*XXX*XXXXX*X
***X*X*********X*****X*X*****X*X*X*X*X*X*******X*X
*XXXXX*XXXXXXX*XXXXX*XXX*X*X*XXXXXXX*X*XXX*X*XXX*X
*****X*X***********X***X*X*X*X*******X***X*X*X***X
*XXX*XXXXX*XXXXX*X*X*XXX*X*X*XXXXX*XXX*XXX*X*XXX*X
*X***X*********X*X*X***X*X*X*****X***X***X*X*X***X
*X*X*XXX*XXXXXXXXX*X*XXXXXXXXX*XXXXXXXXXXXXXXXXX*X
*X*X*X***X*********X*******X*******************X*X
*X*X*X*XXX*X*XXXXX*X*XXXXX*X*XXX*XXX*XXX*X*XXXXX*X
*X*X*X*X***X*X*****X*X*****X***X***X*X***X*X*****X
*XXXXX*X*X*XXXXXXX*XXX*XXXXXXXXX*X*XXXXX*XXX*X*X*X
*****X*X*X*******X*X***********X*X***X***X***X*X*X
*X*X*X*X*XXX*XXX*XXX*X*XXXXX*X*XXX*X*XXXXX*X*X*X*X
*X*X*X*X*X*****X***X*X*X*****X*X***X*****X*X*X*X*X
XXXX*X*XXX*X*X*XXX*XXX*X*X*XXX*X*XXXXXXXXX*XXX*X*X
*****X***X*X*X*X*****X*X*X***X*X*******X***X***X*X
*X*X*X*XXX*XXXXX*XXX*XXX*XXXXX*XXXXXXXXX*XXXXX*XXX
*X*X*X***X***X*****X*X***X*******X***********X***X
*X*X*X*X*X*XXXXXXXXXXX*X*X*X*XXXXXXXXX*XXXXX*XXXXX
*X*X*X*X*X*X***********X*X*X*X***********X*******X
*XXX*XXXXXXXXX*XXX*XXX*X*X*X*X*X*X*X*X*X*XXX*XXXXX
***X***X*******X*****X*X*X*X*X*X*X*X*X*X***X*****X
*X*X*X*X*XXX*X*X*X*X*XXX*XXXXX*X*X*XXXXX*X*XXXXX*X
*X*X*X*X*X***X*X*X*X*X*******X*X*X*****X*X*****X*X
*X*X*XXXXX*X*X*XXX*X*XXX*XXX*X*XXX*X*XXXXX*XXXXX*X
*X*X*X*****X*X***X*X***X*X***X***X*X*****X*X*****X
XX*XXXXX*XXXXX*XXX*X*X*X*X*X*X*X*X*XXX*XXX*XXXXX*X
*******X*X*****X***X*X*X*X*X*X*X*X***X*X***X*****X
*X*XXX*XXX*X*X*X*X*X*XXX*XXXXXXXXX*XXX*XXX*XXXXX*X
*X*X*****X*X*X*X*X*X***X*X***********X*X*******X*X
XX*XXXXXXXXX*X*XXXXX*X*X*X*X*X*X*X*X*X*XXX*XXX*X*X
*********X***X*****X*X*X*X*X*X*X*X*X*X*X*****X*X*X
*XXXXXXX*X*XXXXXXX*X*XXXXX*X*X*X*X*XXX*X*X*X*X*X*X
***X*****X***X*****X*X*****X*X*X*X***X*X*X*X*X*X*X
*XXXXXXX*X*XXXXXXXXXXX*XXXXXXXXX*X*X*XXX*XXXXX*XXX
*X*******X***X*****************X*X*X***X*****X***X
*X*X*X*XXX*XXXXX*XXX*X*X*X*XXXXX*XXXXXXX*XXX*XXXXX
XXXXXXXXXXXXXXXXXXXXXXXXXX*XXXXXXXXXXXXXXXXXXXXXXX
**************************************************